# Syntax Colouring Map For SRF05


# Data types (KEYWORD1)
SRF05	KEYWORD1


# Methods and Functions (KEYWORD2)
setSpeedOfSound	KEYWORD2
getSpeedOfSound	KEYWORD2
setCorrectionFactor	KEYWORD2
getCorrectionFactor	KEYWORD2

setModeSingle	KEYWORD2
setModeAverage	KEYWORD2
setModeMedian	KEYWORD2
setModeRunningAverage	KEYWORD2
getOperationalMode	KEYWORD2

getTime	KEYWORD2
getMillimeter	KEYWORD2
getCentimeter	KEYWORD2
getMeter	KEYWORD2
getInch	KEYWORD2
getFeet	KEYWORD2

determineSpeedOfSound	KEYWORD2
setTriggerLength	KEYWORD2
getTriggerLength	KEYWORD2

lastTime	KEYWORD2


# Constants (LITERAL1)
SRF05_LIB_VERSION	LITERAL1

SRF05_MODE_SINGLE	LITERAL1
SRF05_MODE_AVERAGE	LITERAL1
SRF05_MODE_MEDIAN	LITERAL1
SRF05_MODE_RUN_AVERAGE	LITERAL1


